2 2 2 2 2 2 2 2 2 2 2 2 2 2 2 2 2 2 2 2 2 2 2 2 2 2 2 2 2 2 2 2 2 2 2 2 2 2 2 2 2 2 2 2 2 2 2 2 2 2 2 2 2 2 2 2 2 2 2 2 2 2 2 2 2 2 2 2 2 2 2 2 2 2 2 2 2 2 2 2 2 2 2 2 2 2 2 2 2 5 5 2 2 2 2 2 2 2 2 2 2 2 2 2 2 2 2 5 5 2 2 2 2 2 2 2 2 2 2 2 
2 2 2 2 2 4 3 2 2 2 2 2 2 2 2 2 2 2 2 2 2 2 2 2 2 2 2 2 2 2 2 2 2 2 2 4 3 2 2 2 2 2 2 2 2 2 2 2 2 2 2 2 2 2 2 2 2 2 2 2 2 2 2 2 2 2 4 3 2 2 2 2 2 2 2 2 2 2 2 2 2 2 2 2 2 2 2 2 2 5 5 2 2 2 2 2 4 3 2 2 2 2 2 2 2 2 2 2 2 2 2 2 2 2 2 2 2 2 2 2 
2 2 2 2 2 2 2 2 2 2 2 2 5 2 2 4 3 2 2 2 2 2 2 2 5 5 2 2 4 3 2 2 2 2 2 2 2 2 2 2 2 5 2 2 2 4 3 2 2 2 2 2 2 2 5 5 2 2 4 3 2 2 2 2 2  2 5 5 5 5 5 2 2 2 2 4 3 2 2 2 2 2 2 2 2 2 5 2 4 3 2 2 2 2 2 2 2 2 2 2 5 5 2 2 2 4 3 2 2 2 2 2 2 2 5 5 2 2 4 3
2 2 2 2 2 2 2 2 2 2 2 5 2 5 2 2 2 2 2 2 2 2 2 5 2 12 2 2 2 2 2 2 2 2 5 2 2 2 2 2 2 5 2 2 2 2 2 2 2 2 2 2 2 5 2 2 2 2 2 2 2 2 2 2 2 2 5 5 5 5 5 2 2 2 2 2 2 2 2 2 2 2 2 2 5 2 5 2 2 2 2 2 2 2 5 2 2 2 2 2 2 5 2 2 2 2 2 12 12 2 2 2 2 2 2 2 2 2 2 2
2 2 2 2 2 2 2 2 2 2 13 12 12 12 2 2 2 2 2 2 5 2 2 2 12 2 2 2 2 2 2 2 2 2 2 2 2 2 2 2 5 12 5 2 2 2 2 2 2 2 2 2 12 12 13 12 2 2 2 2 2 2 2 2 2 12 12 13 12 13 12 2 2 2 2 2 2 2 2 2 2 2 2 2 2 2 2 2 13 12 12 2 2 2 2 2 2 2 2 2 2 2 12 12 2 2 2 2 2 2 2 2 2 2 2 2 2 2 2 2
2 6 8 2 2 2 2 2 2 2 2 2 2 2 2 2 6 8 2 5 2 5 2 2 2 2 2 2 2 2 2 6 8 2 2 2 2 2 2 5 12 12 12 5 2 2 6 8 2 2 2 2 2 2 2 2 2 2 2 2 2 6 8 2 2 12 2 2 5 2 2 2 2 2 2 2 6 8 2 2 2 2 12 2 2 2 2 2 2 2 2 6 8 2 2 2 2 2 2 2 2 5 2 2 2 2 6 8 2 2 2 2 2 2 2 2 2 2 17 19
2 7 9 2 2 2 2 11 10 2 2 2 2 2 2 2 7 9 2 2 2 2 11 10 2 2 2 11 10 2 2 7 9 2 2 2 2 11 10 12 12 12 12 12 2 2 7 9 2 2 2 2 11 10 2 2 2 11 10 2 2 7 9 2 12 12 12 11 10 2 2 2 2 2 2 2 7 9 2 2 2 2 12 12 2 2 2 11 10 2 2 7 9 2 2 2 2 11 10 2 2 2 2 2 2 2 7 9 2 2 2 2 11 10 2 2 2 11 18 20
0 0 0 0 0 0 0 0 0 0 0 0 0 0 0 0 0 0 0 2 2 0 0 0 0 0 0 0 0 0 0 0 0 0 0 0 0 0 0 0 0 0 0 0 0 0 0 0 0 0 0 0 0 0 0 0 0 0 0 0 0 0 0 0 0 0 0 0 0 0 0 0 0 0 0 0 0 0 0 2 2 2 0 0 0 0 0 0 0 0 0 0 0 0 0 0 0 0 0 0 0 0 0 0 0 0 0 0 0 0 0 0 0 0 0 0 0 0 0 0
1 1 1 1 1 1 1 1 1 1 1 1 1 1 1 1 1 1 1 2 2 1 1 1 1 1 1 1 1 1 1 1 1 1 1 1 1 1 1 1 1 1 1 1 1 1 1 1 1 1 1 1 1 1 1 1 1 1 1 1 1 1 1 1 1 1 1 1 1 1 1 1 1 1 1 1 1 1 1 2 2 2 1 1 1 1 1 1 1 1 1 1 1 1 1 1 1 1 1 1 1 1 1 1 1 1 1 1 1 1 1 1 1 1 1 1 1 1 1 1
11
10 45 49 51 70 75 80 90 95 97 100